        NO ./path_to_the_north_texture
        SO ./path_to_the_south_texture
    	WE ./path_to_the_west_texture
        EA ./path_to_the_east_texture

F 220,100,0
C 225,30,00


        1111111111111111111111111
        1000000000110000000000001
        1011000000110000000000001
        1001000000000000000000001
111111111011000001110000000000001
100000000011000001110111111111111
111101111111110111000001100011
111101111111110111010101100011
1100000011011000111000000000011
100000000000000011000000000011
100000000000000011010100100011
110000011101010111110111100111
11110111 1110101 101111010N001
11111111 1111111 111111111111









