NO ./textures/red.xpm

SO ./textures/mossy.xpm

EA ./textures/eagle.xpm

WE ./textures/greystone.xpm

F 108,88,98
C 0,239,11





        1111111111111111111111111
        1000000000110000000000001
        1011000000110000000000001
        1001000000000000000000001
111111111011000001110000000000001
100000000011000001110111111111111
111101111111110111000001100011
111101111111110111000101100011
110000001101100011100000000001
100000000000000011000000000011
100000000000000011010100100011
110000011101010111110111100111
11110111 11101011101111 10S001
11111111 11111111111111 111111