1111111111111111111111
1000000000000000000001
1000000000000000000001
1001001001001001000001
1000000000000000000001
1000000000000000000001
1000000000000000000001
1000000000000000111001
1000000000000000001001
1000000000000000001001
1000000000P00000001001
1000000000000000001001
1000000000000000001001
1000000000000000111001
1000000000000000000001
1000000000000000000001
1111111111111111111111
