111111111111111111111111
100000000000000010000001
100000010001111111111101
100000000000100000000011
100000100000011000000001
111100000000000000010001
111000000000000000000111
100010010P00010001111001
100010010000010000001001
100010010100010000001001
100010010111110001111001
100000000000000000000001
111111111111111111111111
